40
40
09 09 09 09 09 09 09 09 09 09 09 09 09 09 09 09 09 09 09 09 09 09 09 09 09 09 09 09 09 09 09 09 09 09 09 09 09 09 09 09 
09 09 09 09 09 09 09 09 09 09 09 09 09 09 09 09 09 01 01 01 01 01 01 01 01 01 01 01 01 01 01 09 09 09 09 09 09 09 09 09 
09 09 01 01 01 01 01 09 09 01 01 01 01 09 09 09 09 01 09 09 09 09 09 09 09 01 09 09 09 09 01 09 09 01 01 01 01 01 01 09 
09 09 01 01 01 02 01 01 01 01 01 01 01 01 01 01 01 01 09 01 01 01 01 09 09 01 01 01 09 01 01 09 09 01 01 01 01 09 01 09 
09 09 01 04 02 01 01 09 09 01 02 01 01 09 09 09 09 01 09 01 01 01 01 09 09 09 09 01 09 01 09 09 09 01 01 02 01 09 01 09 
09 09 01 01 01 01 01 09 09 01 01 01 01 09 11 11 09 01 01 01 01 02 01 09 09 01 01 01 09 01 01 09 09 01 01 01 01 09 01 09 
09 09 09 01 01 01 09 09 09 09 09 09 09 09 11 11 11 09 09 01 01 04 01 09 09 01 09 09 09 09 01 09 09 02 01 01 01 09 01 09 
09 09 09 09 01 09 09 09 09 09 09 11 11 11 11 11 11 11 09 09 09 09 09 09 09 01 01 01 01 09 01 01 01 01 09 09 09 09 01 09 
09 09 09 09 01 09 09 09 09 09 09 09 09 09 09 09 09 09 09 09 09 09 09 09 09 09 09 09 01 09 09 09 09 09 09 09 09 09 01 09 
09 09 01 01 01 01 01 09 09 09 01 01 01 01 01 01 01 01 01 01 01 01 01 01 01 01 01 01 01 01 01 01 01 01 09 01 01 01 01 09 
09 09 01 02 01 01 01 09 09 09 01 01 02 01 09 09 09 09 09 01 09 09 09 09 09 09 09 09 01 09 09 09 09 01 09 01 01 02 01 09 
09 09 01 01 02 01 04 09 09 09 01 01 01 01 09 09 09 01 01 01 01 01 09 11 11 09 01 01 01 04 01 09 09 01 09 01 01 01 03 09 
09 09 01 01 01 01 01 09 09 09 04 01 01 01 09 09 09 01 02 01 01 01 09 11 11 09 01 03 01 01 01 09 09 01 09 01 01 01 01 09 
09 09 09 01 09 01 09 09 09 09 09 01 09 09 09 09 09 01 01 01 03 01 09 11 11 09 01 01 01 01 01 09 09 01 09 01 02 01 01 09 
09 09 09 01 09 01 09 09 09 09 09 01 09 09 09 09 09 01 01 01 02 01 09 11 11 09 01 01 01 03 01 09 09 01 09 01 01 01 01 09 
09 09 09 01 09 01 09 09 09 09 09 01 09 09 09 09 09 09 09 09 09 09 11 11 11 09 09 09 09 09 09 09 09 01 09 09 09 09 09 09 
09 09 09 01 09 01 09 09 09 09 09 01 09 09 09 09 09 09 09 09 09 09 11 11 11 11 11 09 09 09 09 09 09 01 09 09 09 09 09 09 
09 01 01 01 09 01 09 09 09 01 01 01 09 01 01 01 09 09 09 09 09 09 09 09 09 09 09 09 09 09 09 09 09 01 09 09 09 09 09 09 
09 01 09 09 09 01 01 09 09 01 09 09 09 01 09 01 09 09 01 01 01 01 01 09 09 09 01 01 01 01 01 09 09 01 09 01 01 01 01 09 
09 01 01 01 01 09 01 09 09 01 03 01 01 01 09 01 09 09 01 02 01 01 01 09 09 09 02 01 01 01 01 09 09 01 01 01 02 03 01 09 
09 02 01 03 01 09 01 09 09 09 09 09 09 09 09 01 09 09 01 03 02 01 01 09 09 09 03 01 02 01 01 01 01 01 09 01 01 01 01 09 
09 01 02 01 01 09 01 09 09 09 01 01 01 01 09 01 09 09 01 01 01 01 01 09 09 09 01 01 01 01 01 09 09 01 09 01 01 04 01 09 
09 01 01 01 01 09 01 09 09 09 01 09 09 01 01 01 09 09 09 09 01 09 09 09 09 09 09 09 09 09 09 09 09 01 09 09 09 09 09 09 
09 09 09 01 09 09 01 09 09 09 01 09 09 09 09 09 09 09 09 09 01 09 11 11 11 11 11 11 11 11 11 11 09 01 09 09 09 09 09 09 
09 09 09 01 09 09 01 09 09 09 01 01 01 09 09 09 09 09 09 09 01 09 09 09 11 11 11 11 11 11 11 11 09 01 09 09 09 09 09 09 
09 09 09 01 09 09 01 01 01 01 09 09 01 01 01 09 09 09 01 01 01 01 01 09 11 09 09 09 09 09 09 09 09 01 09 09 09 09 09 09 
09 01 01 01 01 01 09 09 09 01 09 01 01 03 01 09 09 09 01 02 01 01 01 09 11 09 01 01 01 01 09 09 09 01 01 01 01 01 09 09 
09 01 02 01 01 01 09 09 09 01 09 01 01 01 01 01 01 01 01 01 02 01 01 09 11 09 01 02 03 01 09 09 09 01 02 01 03 01 09 09 
09 01 01 01 04 01 09 09 09 01 09 01 03 01 01 09 09 09 01 01 01 01 01 09 09 09 01 01 01 01 09 09 09 01 01 01 01 01 09 09 
09 01 01 03 01 01 09 09 09 01 09 09 09 09 09 09 09 09 09 09 09 09 09 09 09 09 09 09 09 09 09 09 09 09 09 01 09 09 09 09 
09 09 09 01 09 09 09 09 09 01 01 01 01 01 01 01 01 01 01 01 01 01 01 01 01 01 01 01 01 01 01 01 01 01 01 01 01 01 09 09 
09 09 09 01 09 11 11 11 09 09 09 09 09 09 09 09 09 09 09 09 09 09 09 09 09 09 09 09 09 09 09 09 09 09 09 01 09 09 09 09 
09 09 09 01 09 11 11 11 11 09 09 09 09 09 09 09 09 09 09 09 09 11 11 11 09 09 09 09 09 09 09 09 09 09 09 01 09 09 09 09 
09 09 09 01 09 09 09 11 11 09 09 09 09 09 09 09 09 09 09 09 09 09 11 11 09 01 01 01 09 01 01 01 01 01 01 01 09 09 09 09 
09 01 01 01 01 01 09 11 11 09 01 01 01 01 01 09 09 01 01 01 01 09 11 11 09 01 09 01 09 01 09 09 09 09 09 01 09 09 09 09 
09 01 01 02 01 01 09 11 11 09 01 01 01 01 01 01 01 01 02 01 01 09 09 09 09 01 09 01 09 01 09 11 11 09 01 01 01 01 09 09 
09 01 01 01 01 01 09 09 09 09 01 03 01 02 01 09 09 01 01 01 01 01 01 09 09 01 09 01 09 01 09 11 11 09 01 02 03 01 09 09 
09 02 01 01 03 01 01 01 01 01 01 01 01 01 01 09 09 01 01 01 04 09 01 09 09 01 09 01 09 01 09 11 11 09 01 01 01 01 09 09 
09 01 01 01 01 01 09 09 09 09 01 02 01 01 01 09 09 09 09 09 09 09 01 01 01 01 09 01 01 01 09 11 11 09 01 01 01 04 09 09 
09 09 09 09 09 09 09 09 09 09 09 09 09 09 09 09 09 09 09 09 09 09 09 09 09 09 09 09 09 09 09 11 11 09 09 09 09 09 09 09