40
40
20 20 20 20 20 20 20 20 20 20 20 20 20 20 20 20 20 28 23 23 23 23 23 27 28 23 23 23 23 27 20 20 20 23 23 23 23 23 23 27 
28 23 23 23 23 23 27 20 20 20 20 20 20 20 20 20 20 21 01 01 01 01 01 19 21 01 01 01 01 22 23 27 21 01 01 01 01 01 01 19 
21 01 01 01 01 01 22 23 23 23 23 23 23 23 23 23 23 24 01 04 01 02 01 22 24 01 01 01 01 01 01 19 21 01 01 01 01 01 01 19 
21 01 02 01 01 01 01 01 01 01 01 01 01 01 01 01 01 01 01 03 01 01 01 01 01 01 02 01 01 20 01 22 24 01 01 02 01 03 01 19 
21 01 01 04 01 01 16 17 17 17 17 17 17 17 17 17 17 18 01 01 02 01 01 16 17 17 17 17 17 20 01 01 01 04 01 01 03 01 01 19 
21 03 01 01 02 01 19 20 20 28 23 23 23 27 09 09 09 21 01 01 01 01 01 19 09 09 09 09 09 21 01 16 18 01 01 01 01 01 01 19 
21 01 01 01 01 01 19 20 20 21 01 01 01 19 09 09 09 26 17 17 17 17 17 25 09 09 09 09 09 21 01 19 26 17 18 01 16 17 17 25 
26 17 18 01 16 17 25 20 20 21 01 01 01 19 09 09 09 09 09 09 09 09 09 09 09 09 09 09 09 21 01 19 20 20 21 01 19 20 20 20 
28 23 24 01 22 23 23 27 20 26 17 17 17 25 20 09 09 28 23 23 23 23 27 09 09 09 09 09 09 21 01 19 20 20 21 01 19 20 20 20 
21 01 01 01 01 01 01 19 20 20 20 20 20 20 20 09 09 21 01 01 01 01 19 09 28 23 23 23 23 27 01 19 20 28 24 01 22 23 23 27 
21 01 20 01 01 01 01 22 23 23 23 23 23 23 23 23 23 24 01 02 01 01 19 09 21 01 01 01 01 19 01 19 20 21 01 01 01 01 01 19 
21 01 20 01 01 04 03 01 01 01 01 01 01 01 01 01 01 01 01 01 01 01 19 09 21 01 01 01 01 19 01 19 20 21 01 04 01 01 01 19 
21 01 20 01 02 01 01 16 17 18 01 16 17 18 01 16 17 18 01 01 03 01 22 23 24 01 02 01 01 19 01 19 20 21 01 01 02 01 01 19 
21 01 20 01 01 01 01 19 09 21 01 19 20 21 01 19 20 21 01 01 01 01 01 01 01 01 01 01 01 19 01 19 20 21 01 01 01 01 01 19 
21 01 19 17 17 17 17 25 09 21 01 19 20 21 01 19 20 26 17 17 17 17 17 17 17 18 01 01 01 19 01 19 20 26 17 17 17 18 01 19 
21 01 19 09 09 09 09 09 09 21 01 19 20 21 01 19 20 20 09 09 09 09 09 09 09 26 17 17 17 25 01 19 20 20 20 20 20 21 01 19 
21 01 19 09 09 09 09 09 09 21 01 19 20 21 01 22 23 23 23 23 23 23 23 27 28 23 23 23 23 27 01 19 20 20 20 20 20 20 01 20 
21 01 22 23 23 23 23 27 09 21 01 19 20 21 01 01 01 01 01 01 01 01 01 19 21 01 01 01 01 19 01 19 20 01 01 01 01 20 01 20 
21 01 01 01 01 01 01 19 28 24 01 22 23 24 16 17 17 18 03 01 01 01 01 19 21 01 01 03 01 19 01 19 20 01 20 20 01 01 01 20 
26 17 18 03 01 01 01 19 21 01 01 01 01 01 19 09 09 21 01 01 02 01 01 19 21 01 01 01 01 19 01 19 20 01 20 20 20 20 20 20 
09 09 21 01 01 01 01 19 21 01 01 01 02 01 19 09 09 21 01 01 01 01 01 19 21 01 17 17 17 25 01 19 20 01 01 01 01 01 20 20 
09 09 21 01 02 01 01 19 21 01 01 01 01 01 19 09 09 21 01 01 01 01 01 19 21 01 01 01 01 01 01 19 20 20 20 20 20 01 20 20 
09 09 21 01 01 01 01 19 21 01 02 01 01 01 19 09 09 26 17 17 17 17 17 25 26 17 17 17 18 01 16 25 20 20 20 20 20 01 20 20 
09 09 26 17 18 01 16 25 26 17 17 18 01 16 25 09 09 09 09 09 28 23 23 23 27 09 09 09 21 01 19 20 20 20 20 20 20 01 20 20 
20 20 20 20 20 01 20 20 20 28 23 24 01 22 23 27 09 09 28 23 24 01 01 01 19 09 09 09 21 02 19 20 20 20 20 20 21 01 19 20 
20 01 01 01 20 01 20 20 20 21 01 01 01 01 01 19 09 09 21 01 01 01 01 01 19 23 23 23 21 01 19 20 20 20 20 20 21 01 19 20 
20 01 20 01 01 01 20 20 20 21 01 01 01 01 01 19 09 09 21 01 21 01 01 01 19 01 01 01 21 01 22 23 23 23 23 23 24 01 22 27 
20 01 20 20 20 20 20 20 20 21 01 01 02 01 01 19 09 28 24 01 26 17 17 17 25 01 01 01 21 01 01 01 01 01 01 01 01 01 01 19 
20 01 01 01 01 01 01 20 20 21 01 01 01 01 04 19 09 21 01 01 01 01 19 20 21 01 01 01 21 01 16 17 17 17 18 01 16 17 17 25 
20 20 20 20 20 20 01 20 20 21 01 01 01 01 01 19 09 21 01 01 01 01 19 20 21 01 01 01 21 01 19 20 20 20 21 01 19 20 20 20 
20 01 01 01 01 01 01 20 20 26 17 18 01 23 23 23 23 24 01 02 01 04 19 20 26 17 17 17 21 01 19 20 20 20 21 01 19 20 20 20 
20 01 20 20 20 20 20 20 20 20 20 21 01 01 01 01 01 01 01 01 01 01 19 09 09 09 09 09 21 01 19 20 20 20 21 01 19 20 20 20 
21 01 19 20 20 20 20 20 20 28 23 23 23 23 27 20 20 20 28 23 23 23 27 09 09 09 09 09 21 01 19 20 28 23 24 01 22 23 27 20 
21 01 22 23 23 23 23 27 20 21 01 01 01 01 22 23 23 23 24 01 01 01 19 09 09 28 23 23 24 01 22 27 21 01 01 01 01 01 19 20 
21 01 01 01 01 01 01 19 20 21 01 01 01 01 01 01 01 01 01 01 01 01 19 09 09 21 01 01 01 01 01 19 21 01 01 01 01 01 19 20 
21 01 01 01 01 01 01 19 20 21 01 02 03 01 16 17 17 17 18 02 01 01 19 09 09 21 01 01 02 01 01 19 21 01 01 02 01 01 19 20 
21 01 02 01 01 01 01 22 23 24 01 01 01 01 19 20 20 20 21 01 01 01 19 09 09 21 01 01 01 01 01 19 21 01 01 01 01 01 19 20 
21 01 01 01 01 01 01 01 01 01 01 01 01 01 19 20 20 20 21 01 01 01 22 23 23 24 01 01 01 01 01 19 21 01 01 01 02 01 19 20 
21 01 01 01 01 02 01 16 17 17 17 17 17 17 25 20 20 20 21 01 04 01 01 01 01 01 02 01 01 01 01 19 26 17 17 17 17 17 25 20 
26 17 17 17 17 17 17 25 20 20 20 20 20 20 20 20 20 20 26 17 17 17 17 17 17 17 17 17 17 17 17 25 20 20 20 20 20 20 20 20