40
40
29 23 23 23 23 30 20 20 29 23 23 23 23 23 23 23 23 23 30 20 29 23 23 23 23 23 23 23 23 23 23 23 23 23 23 30 25 26 25 26 
21 15 15 15 15 22 23 23 21 15 15 15 15 15 15 15 15 15 19 20 21 15 15 15 15 15 15 15 15 15 15 15 15 15 15 19 26 26 26 26 
21 15 15 01 15 15 15 15 15 15 16 17 17 17 17 17 18 15 22 23 24 15 16 17 17 17 18 15 16 17 18 15 29 24 15 22 23 30 25 26 
21 15 01 15 15 16 18 15 21 15 22 23 23 23 30 21 15 03 15 15 15 15 19 20 29 23 24 15 22 30 21 15 21 15 15 15 15 19 26 26 
21 15 03 15 15 19 21 15 21 15 15 15 15 15 19 21 15 15 01 15 16 17 28 20 21 15 15 01 15 19 21 15 21 15 15 15 15 19 26 25 
27 18 15 16 17 28 21 15 27 17 17 17 18 15 19 21 15 15 15 15 19 06 07 08 21 15 03 15 15 19 21 15 21 15 01 03 15 19 20 20 
20 21 15 19 20 20 21 15 29 23 23 23 24 15 19 27 17 18 15 16 28 09 10 11 27 17 17 17 17 28 21 15 21 15 15 15 15 19 20 20 
20 21 15 19 20 20 21 15 21 15 15 15 15 15 19 20 20 21 15 19 20 12 13 14 20 29 23 23 23 23 21 15 27 17 18 15 16 28 20 20 
29 24 15 22 30 21 15 15 21 15 29 23 23 23 23 30 23 24 15 22 23 23 23 23 23 24 15 15 15 15 21 15 20 20 21 15 19 20 20 20 
21 15 15 15 19 21 15 16 21 15 21 15 15 15 15 19 15 15 15 15 15 15 15 15 15 15 15 15 15 15 21 15 29 23 24 15 22 23 30 20 
21 15 01 15 19 21 15 19 21 15 21 15 15 03 15 22 15 16 18 15 15 22 23 30 17 17 15 15 15 15 21 15 21 15 15 15 15 15 19 20 
21 03 15 15 19 21 15 19 21 15 15 15 05 15 15 15 15 19 21 15 15 15 15 19 29 23 23 23 23 23 24 15 21 15 15 01 15 15 19 20 
21 15 15 15 19 21 15 19 21 15 19 15 15 15 15 16 17 28 21 15 03 15 15 19 21 15 15 15 15 15 15 15 21 15 01 03 15 15 19 20 
21 01 15 15 29 24 15 19 21 15 22 23 23 23 30 06 07 08 21 15 15 15 15 19 21 15 16 17 17 17 17 17 21 15 15 15 01 15 19 20 
27 18 15 16 21 15 15 19 21 15 15 15 15 15 19 09 10 11 21 15 16 17 28 28 21 15 19 20 20 20 20 20 27 17 17 18 15 16 28 20 
20 21 15 19 21 15 16 28 27 17 17 17 18 15 19 09 25 11 21 15 19 20 20 20 21 15 19 23 23 23 23 30 20 20 20 21 15 19 20 20 
20 21 15 19 21 15 22 23 23 23 23 23 24 15 19 12 13 14 25 15 25 25 26 25 21 15 19 15 01 15 15 19 25 25 26 25 15 25 26 25 
20 21 15 19 21 15 15 15 15 15 15 15 15 15 19 25 26 25 25 15 15 15 15 20 21 15 19 15 15 15 15 19 26 26 25 26 15 25 26 20 
29 24 15 22 23 30 20 20 17 17 18 15 16 17 28 25 15 15 15 25 26 25 15 20 21 15 15 15 15 05 15 19 26 15 15 15 15 26 25 20 
21 15 15 15 15 19 15 15 20 29 24 15 22 23 30 26 15 26 15 15 15 15 15 20 27 17 18 15 01 15 15 19 25 15 25 26 25 26 25 20 
21 15 15 15 03 19 15 15 20 21 15 15 15 15 19 25 15 25 26 26 25 25 20 20 20 20 21 15 15 15 15 19 26 15 25 15 15 15 15 20 
21 15 01 15 15 19 20 20 20 21 15 03 15 15 19 25 15 15 15 15 15 15 15 20 26 26 27 18 15 16 17 28 25 15 15 15 25 26 15 20 
21 15 15 15 15 19 06 07 08 21 15 15 15 15 19 25 26 25 25 26 25 25 15 20 26 25 20 21 15 19 20 26 26 25 25 26 25 25 15 20 
27 17 18 15 16 28 09 10 11 21 15 15 15 15 19 20 26 25 26 26 20 20 15 20 25 26 20 21 15 19 20 25 26 25 26 26 20 20 15 20 
20 20 21 15 19 20 12 13 14 20 20 20 20 20 20 20 25 26 25 26 29 24 15 20 26 26 20 21 15 19 20 20 29 23 23 23 30 21 15 19 
29 23 24 15 22 23 23 30 20 20 20 29 23 23 23 23 23 23 23 23 24 15 15 15 20 29 23 24 15 22 23 30 21 15 15 15 19 21 15 19 
21 15 15 15 15 15 15 19 20 29 23 24 15 15 15 15 15 15 15 15 15 15 15 15 20 21 15 15 15 15 15 19 21 15 15 15 22 24 15 19 
21 15 15 15 15 15 15 19 20 21 15 15 15 15 16 17 17 18 15 16 18 15 15 15 20 21 15 15 03 05 15 19 21 15 01 15 15 15 15 19 
21 15 01 15 01 15 15 19 20 21 15 01 15 15 22 30 21 15 15 15 27 17 17 17 20 21 15 15 01 15 15 19 21 15 15 03 16 18 15 19 
21 15 15 15 15 15 15 19 20 21 15 15 15 15 15 19 21 15 15 01 15 15 15 19 20 21 15 15 15 15 15 19 21 15 15 15 19 21 15 19 
21 15 15 15 05 15 15 19 20 21 15 15 01 15 15 19 21 15 15 15 16 18 15 19 20 27 17 17 17 17 17 28 27 17 17 17 28 21 15 19 
27 17 18 15 16 17 17 28 20 27 17 18 15 16 17 28 27 17 17 17 28 21 15 19 20 20 20 20 20 20 20 20 20 20 20 20 20 21 15 19 
20 20 21 15 19 20 20 06 07 08 20 21 15 22 23 30 20 20 20 20 20 21 15 22 23 23 23 23 23 23 23 30 29 23 23 23 23 30 15 19 
29 23 24 15 22 23 30 09 10 11 20 21 15 15 15 19 20 20 20 20 20 21 15 15 15 15 15 15 15 15 15 19 21 15 15 15 15 19 15 19 
21 15 15 15 15 15 19 12 13 14 20 21 15 03 15 19 29 23 23 23 23 30 17 17 17 17 17 18 15 16 17 28 21 15 15 15 15 19 15 19 
21 15 01 15 15 15 22 23 23 23 23 21 15 15 15 19 21 15 15 15 15 19 06 07 08 29 23 24 15 22 23 30 21 15 15 01 15 22 15 19 
21 15 15 01 03 15 15 15 15 15 15 21 15 15 15 19 21 15 15 05 15 19 09 10 11 21 15 15 15 01 15 22 24 15 03 15 15 15 15 19 
21 15 15 15 15 15 16 17 17 18 15 27 17 17 17 28 21 15 01 15 15 19 09 25 11 21 15 15 03 15 15 15 15 15 01 15 15 16 17 28 
27 17 17 17 17 17 28 20 20 21 15 15 15 15 15 15 15 15 15 15 15 19 09 10 11 21 15 15 15 15 15 16 18 15 15 15 15 19 20 20 
20 20 20 20 20 20 20 20 20 27 17 17 17 17 17 17 17 17 17 17 17 28 12 13 14 27 17 17 17 17 17 28 27 17 17 17 17 28 20 20