40
40
22 23 22 23 22 23 22 23 22 23 22 23 22 23 22 23 22 23 22 23 22 23 22 23 22 23 22 23 22 23 22 23 22 23 22 23 22 23 22 23 
20 21 20 21 20 21 20 21 20 21 20 21 20 21 20 21 20 21 20 21 20 21 20 21 20 21 20 21 20 21 20 21 20 21 20 21 20 21 20 21 
22 23 02 01 01 01 03 22 23 22 23 02 01 01 03 17 17 17 02 01 01 03 17 17 17 01 01 01 01 01 01 01 01 01 01 01 01 01 01 17 
20 21 01 01 01 01 01 20 21 20 21 01 01 01 01 01 01 01 01 01 01 01 01 01 01 01 17 17 17 17 17 17 17 17 17 01 17 17 01 17 
22 23 01 01 01 01 01 22 23 22 23 01 01 01 01 17 17 17 01 01 01 01 22 23 17 01 22 23 22 23 22 23 17 02 01 01 03 17 01 17 
20 21 04 01 01 01 05 20 21 20 21 04 01 01 05 17 22 23 01 01 01 01 20 21 17 01 20 21 20 21 20 21 17 01 01 01 01 17 01 17 
22 23 22 23 01 22 23 22 23 22 23 17 01 22 23 17 20 21 04 01 01 05 22 23 17 01 01 01 01 01 01 22 23 04 01 01 05 17 01 17 
20 21 20 21 01 20 21 20 21 20 21 17 01 20 21 17 22 23 22 23 22 23 20 21 22 23 22 23 22 23 01 20 21 22 23 22 23 17 01 17 
16 16 16 16 01 16 22 23 24 25 17 17 01 22 23 17 20 21 20 21 20 21 17 17 20 21 20 21 20 21 01 22 23 20 21 20 21 17 01 17 
16 02 01 01 01 03 20 21 26 27 01 01 01 20 21 17 22 23 02 01 01 01 03 22 23 22 23 17 17 17 01 20 21 17 17 17 17 17 01 17 
16 01 01 01 01 01 16 16 17 17 01 22 23 02 03 28 20 21 01 01 01 01 01 20 21 20 21 17 02 01 01 22 23 01 01 01 01 01 01 17 
16 01 01 01 01 01 01 01 01 01 01 20 21 04 05 17 22 23 01 01 01 01 01 01 01 01 01 01 01 01 01 20 21 01 17 17 17 17 17 17 
16 04 01 01 01 05 16 16 17 17 01 17 17 17 17 17 20 21 01 01 01 01 01 22 23 01 17 17 04 01 05 22 23 01 01 01 01 01 01 17 
22 23 16 01 22 23 22 23 22 23 01 01 01 01 01 01 01 01 01 01 01 01 05 20 21 01 01 03 17 17 17 20 21 17 17 17 17 17 01 17 
20 21 16 01 20 21 20 21 20 21 22 23 17 01 22 23 22 23 22 23 22 23 22 23 17 01 01 01 01 01 01 22 23 01 01 01 01 01 01 17 
17 17 17 01 17 17 17 17 06 17 20 21 17 01 20 21 20 21 20 21 20 21 20 21 17 04 01 05 22 23 01 20 21 01 22 23 22 23 22 23 
17 01 01 01 17 01 01 01 22 23 01 01 01 01 01 01 01 01 01 01 01 01 01 01 01 22 23 17 20 21 01 22 23 01 20 21 20 21 20 21 
17 01 17 17 17 01 17 01 20 21 01 17 17 17 22 23 22 23 17 17 01 17 17 17 01 20 21 22 23 17 01 20 21 01 22 23 22 23 22 23 
17 01 01 01 01 01 17 01 06 02 01 01 01 03 20 21 20 21 02 01 01 01 03 17 01 17 17 20 21 17 01 22 23 01 20 21 20 21 20 21 
17 17 17 17 17 17 17 01 06 01 01 01 01 01 22 23 22 23 01 01 01 01 01 17 01 01 01 17 02 01 01 20 21 01 01 01 01 01 03 17 
17 01 01 01 01 01 17 01 06 01 01 01 01 01 20 21 20 21 01 01 01 01 01 22 23 17 01 17 01 01 01 22 23 01 17 01 01 01 01 17 
17 01 22 23 17 01 01 01 06 04 01 01 01 05 22 23 22 23 04 01 01 01 05 20 21 17 01 17 01 01 01 20 21 01 17 01 01 01 01 17 
17 01 20 21 22 23 22 23 22 23 22 23 01 17 20 21 20 21 22 23 22 23 22 23 22 23 01 17 04 01 05 22 23 01 17 04 01 01 05 17 
17 01 17 17 20 21 20 21 20 21 20 21 01 22 23 22 23 17 20 21 20 21 20 21 20 21 01 22 23 22 23 20 21 22 23 22 23 01 17 17 
17 01 22 23 22 23 17 17 17 17 17 17 01 20 21 20 21 17 17 17 17 17 17 17 17 17 01 20 21 20 21 17 17 20 21 20 21 01 22 23 
17 01 20 21 20 21 01 01 01 01 01 01 01 01 01 01 01 01 01 17 01 01 01 01 01 01 01 01 01 01 22 23 17 17 17 17 17 01 20 21 
17 01 17 01 01 01 01 22 23 17 17 17 01 17 22 23 22 23 01 17 01 17 17 22 23 22 23 17 17 01 20 21 17 02 01 03 17 01 01 17 
17 01 17 01 17 17 17 20 21 17 02 01 01 03 20 21 20 21 01 17 01 01 01 20 21 20 21 02 01 01 03 22 23 01 01 01 03 17 01 17 
17 01 17 01 01 01 01 17 22 23 01 01 01 01 22 23 22 23 01 17 17 17 01 24 25 22 23 01 01 01 01 20 21 01 01 01 01 17 01 17 
17 01 17 17 17 17 01 17 20 21 01 01 01 01 20 21 20 21 01 01 01 17 01 26 27 20 21 01 01 01 01 01 01 01 01 01 01 17 01 17 
17 01 01 01 01 01 01 22 23 17 04 01 01 05 22 23 22 23 22 23 01 01 01 22 23 22 23 04 01 01 05 22 23 04 01 01 05 17 01 17 
17 17 17 01 17 17 17 20 21 17 17 01 22 23 20 21 20 21 20 21 22 23 17 20 21 20 21 22 23 22 23 20 21 22 23 17 22 23 01 17 
17 22 23 01 22 23 22 23 22 23 17 01 20 21 17 22 23 17 17 17 20 21 17 17 22 23 17 20 21 20 21 22 23 20 21 17 20 21 01 17 
17 20 21 01 20 21 20 21 20 21 17 01 01 01 03 20 21 17 02 01 01 01 03 17 20 21 02 01 01 01 03 20 21 17 17 17 17 17 01 17 
17 02 01 01 01 03 22 23 22 23 22 23 01 01 01 17 22 23 01 01 01 01 01 22 23 17 01 01 01 01 01 17 22 23 02 01 01 01 01 17 
17 01 01 01 01 01 20 21 20 21 20 21 01 01 01 17 20 21 01 01 01 01 01 20 21 17 01 01 01 01 01 17 20 21 01 01 01 01 01 17 
17 01 01 01 01 01 01 01 01 01 01 17 04 01 05 22 23 17 04 01 01 01 01 17 22 23 01 01 01 01 01 01 01 01 01 01 01 01 01 17 
17 01 01 01 01 01 22 23 17 17 01 17 17 17 17 20 21 17 17 01 01 01 05 17 20 21 04 01 01 01 05 17 17 17 01 01 01 01 01 17 
17 04 01 01 01 05 20 21 22 23 01 01 01 01 01 01 01 01 01 01 22 23 22 23 22 23 22 23 22 23 22 23 22 23 04 01 01 01 05 17 
17 17 17 17 17 17 17 17 20 21 17 17 17 17 17 17 17 17 17 17 20 21 20 21 20 21 20 21 20 21 20 21 20 21 17 17 17 17 17 17