40
40
21 21 21 21 21 21 21 21 21 26 24 24 24 24 24 27 26 24 24 24 24 24 27 21 21 26 24 24 24 24 27 21 21 26 24 24 24 24 24 27 
21 26 24 24 24 24 27 21 21 22 06 06 11 06 06 20 22 06 06 06 06 06 23 24 24 25 06 06 06 06 23 24 24 25 06 06 06 06 06 20 
21 22 06 06 11 06 23 24 24 25 06 01 06 06 06 20 22 06 06 11 01 06 06 06 06 06 11 06 06 06 06 06 06 06 06 11 06 06 06 20 
21 22 06 06 11 06 06 06 06 06 06 06 06 06 06 20 22 06 06 06 06 06 17 18 18 19 06 06 11 06 17 18 18 19 06 06 06 06 06 20 
21 22 06 06 06 06 17 18 18 19 06 06 06 06 06 20 28 18 18 18 18 18 29 21 21 22 06 06 06 06 20 21 21 22 06 06 01 06 06 20 
21 22 06 11 06 06 20 21 21 28 18 19 11 17 18 29 24 24 24 24 24 24 24 24 21 28 18 18 18 18 29 21 21 22 06 06 06 06 11 20 
21 28 18 19 06 17 29 21 21 08 09 09 06 09 09 09 06 06 06 06 06 06 06 06 09 09 09 09 20 21 21 21 21 28 18 19 06 17 18 29 
21 21 21 22 06 20 21 21 21 05 17 18 18 18 18 18 18 18 18 18 18 18 18 18 18 18 19 06 20 21 21 21 21 21 21 22 06 20 21 21 
26 24 24 25 07 21 21 21 21 05 23 24 24 24 24 24 24 24 24 24 24 27 21 21 26 24 25 06 23 24 27 21 21 21 21 22 06 20 21 21 
22 06 03 03 04 21 08 09 09 06 06 06 06 06 06 06 03 03 03 03 06 20 21 21 22 11 06 06 06 06 20 21 21 26 24 25 06 23 27 21 
22 06 23 24 27 21 05 17 18 18 18 19 06 17 18 18 21 26 24 25 06 23 24 27 22 06 06 06 11 06 23 24 24 25 06 11 06 06 20 21 
22 06 06 06 20 21 05 20 21 26 24 25 06 23 24 27 21 22 06 06 06 06 06 20 22 06 06 06 06 06 06 06 06 06 06 06 11 06 20 21 
22 06 11 06 20 21 05 20 21 22 06 06 06 06 06 20 21 22 06 11 06 06 06 20 22 06 06 06 06 06 17 18 18 19 06 06 01 06 20 21 
22 06 06 11 20 21 05 20 21 22 01 06 11 06 06 20 21 22 06 06 06 06 06 20 28 18 18 18 18 18 29 21 21 22 06 06 06 06 20 21 
22 01 06 06 20 21 05 20 21 22 06 06 06 06 06 20 21 22 06 06 06 06 11 20 21 21 21 21 21 21 21 21 21 28 18 19 06 17 29 21 
28 19 06 17 29 21 05 20 21 28 18 18 18 18 18 29 21 28 18 18 18 18 18 29 21 21 21 21 21 21 21 21 26 24 24 25 06 20 21 21 
21 22 06 20 21 21 05 23 24 24 26 24 24 24 24 24 24 24 24 24 24 24 24 24 24 24 24 24 24 24 24 24 25 06 06 06 06 20 21 21 
26 25 06 23 24 24 02 03 06 07 22 06 11 06 06 06 03 03 03 03 03 03 03 03 06 06 06 06 06 06 06 06 03 03 17 19 06 20 21 21 
22 06 06 06 06 06 20 21 19 07 22 06 06 06 06 17 21 21 26 24 24 24 27 21 18 18 19 06 17 18 18 18 21 26 24 25 06 23 24 27 
22 06 06 11 06 06 20 21 22 07 22 01 06 06 11 20 21 21 22 11 06 06 20 21 21 21 22 06 20 21 21 21 21 22 06 06 06 06 06 20 
22 06 06 06 06 06 20 21 22 07 22 06 06 06 06 20 21 21 22 06 06 06 20 21 21 21 22 06 20 21 21 21 21 22 06 06 06 11 06 20 
22 06 11 06 01 06 20 21 22 07 28 18 18 18 18 29 21 21 28 19 06 17 29 21 24 24 25 06 23 24 27 21 21 22 06 11 01 06 06 20 
22 06 06 06 06 06 20 21 22 06 09 09 09 09 09 09 09 09 09 09 06 09 09 09 06 06 06 06 06 06 20 21 21 22 06 06 06 06 06 20 
28 18 19 06 17 18 29 21 28 18 18 19 06 17 18 18 18 18 18 18 18 18 18 18 18 18 18 18 18 18 29 21 21 28 18 19 06 17 18 29 
26 24 25 06 20 21 21 21 21 21 21 22 06 20 21 21 21 26 24 24 24 24 27 21 21 21 26 24 24 24 27 21 21 26 24 25 06 23 24 27 
22 06 06 06 20 08 09 09 21 26 24 25 06 23 24 27 21 22 06 06 06 06 20 21 21 21 22 06 06 06 20 21 21 22 06 06 06 06 06 20 
22 06 17 18 29 05 17 05 21 22 06 06 06 06 06 20 21 22 06 06 06 06 20 21 21 21 22 06 11 06 20 21 21 22 06 06 11 06 11 20 
22 06 09 09 09 06 20 05 21 22 06 06 11 06 06 23 24 25 06 06 11 06 20 21 21 21 22 06 06 06 20 21 21 22 06 06 06 06 06 20 
28 18 18 18 18 18 29 05 21 22 06 06 06 06 11 06 06 06 06 11 06 06 23 24 21 21 28 18 18 18 29 21 21 28 18 18 18 18 18 29 
22 09 09 09 09 10 21 05 21 22 06 01 06 06 06 17 18 19 06 06 06 11 06 06 09 09 09 09 09 09 09 09 09 10 24 24 24 27 21 21 
22 06 17 18 19 06 09 06 21 28 18 18 18 18 18 29 21 22 06 06 06 06 17 18 18 18 18 18 18 18 18 18 19 06 06 06 06 20 21 21 
22 06 20 21 28 18 18 18 21 21 21 21 21 21 21 21 21 28 18 18 18 18 29 21 21 21 21 21 21 21 21 21 28 18 18 19 06 20 21 21 
22 06 23 24 24 24 24 27 21 26 24 24 24 24 24 27 21 26 24 24 24 24 24 27 21 26 24 24 24 24 24 27 21 26 24 25 06 23 24 27 
22 06 06 06 06 06 06 20 21 22 06 06 06 06 06 23 24 25 06 03 03 03 06 20 21 22 06 06 06 06 06 20 21 22 06 06 06 06 06 20 
28 18 18 18 18 19 06 20 21 22 06 06 11 06 06 06 06 03 04 26 24 25 06 20 21 22 06 11 06 06 06 20 21 22 11 06 06 06 06 20 
22 09 09 09 10 22 06 20 21 22 06 06 01 11 06 17 18 26 24 25 06 06 06 20 21 22 06 06 06 11 06 23 24 25 06 06 06 11 06 20 
22 06 17 19 06 09 06 20 21 28 19 06 06 06 06 20 21 22 06 06 06 17 18 29 24 25 06 06 06 06 06 06 06 06 06 06 01 06 06 20 
22 06 20 28 18 18 18 29 21 24 25 06 06 06 06 20 21 22 06 17 18 29 08 09 06 06 06 11 06 06 06 17 18 19 06 06 11 06 06 20 
22 06 09 09 09 09 09 09 09 06 06 06 17 18 18 29 21 22 06 09 09 09 06 17 18 18 18 18 18 18 18 29 21 22 06 06 06 06 06 20 
28 18 18 18 18 18 18 18 18 18 18 18 29 21 21 21 21 28 18 18 18 18 18 29 21 21 21 21 21 21 21 21 21 28 18 18 18 18 18 29