40
40
11 11 11 11 11 11 11 11 11 11 11 11 11 11 11 11 11 11 11 11 11 11 11 11 11 11 11 11 11 11 11 11 11 11 11 11 11 11 11 11 
11 11 11 11 11 11 11 11 11 1 1 1 1 1 11 11 11 11 11 11 11 11 11 11 11 11 11 11 1 1 1 11 11 11 11 11 11 11 11 11 
11 11 1 1 1 1 1 11 11 1 3 1 1 1 11 1 1 1 1 1 1 1 11 1 1 1 1 1 1 1 1 1 1 1 1 1 1 1 1 11 
11 11 2 1 1 1 1 11 11 1 1 11 11 11 11 1 11 11 11 11 11 1 11 1 1 1 2 11 11 11 11 11 11 1 11 11 11 1 1 11 
11 11 1 1 2 1 1 11 11 1 1 11 11 11 1 1 1 11 11 11 11 1 11 1 1 1 2 11 1 1 11 1 1 1 11 11 11 11 1 11 
11 11 1 1 1 1 1 11 11 1 2 1 11 11 11 11 1 11 11 11 1 1 11 2 1 1 2 11 1 1 11 1 1 1 1 1 1 1 1 11 
11 11 1 3 1 1 1 11 11 11 11 1 1 11 11 11 1 1 1 1 1 11 11 11 11 11 11 11 1 1 11 11 11 11 11 1 11 1 1 11 
11 11 1 1 11 11 11 2 1 1 1 1 11 11 11 11 1 1 1 1 1 1 1 1 1 1 1 1 1 1 1 1 1 1 1 2 11 1 11 11 
11 1 1 1 1 1 1 1 1 1 13 13 13 1 1 1 3 1 1 11 11 11 1 1 1 11 11 11 11 11 1 1 11 11 1 1 11 1 11 11 
11 1 1 1 11 11 11 1 1 13 13 13 13 1 11 11 1 1 11 11 11 11 1 11 1 11 11 11 11 11 1 11 11 11 1 1 11 1 1 11 
11 1 1 11 11 1 1 11 1 13 13 13 13 1 11 4 4 1 1 11 11 11 1 11 1 1 1 1 1 1 1 11 11 11 1 13 13 1 1 11 
11 1 1 11 11 1 1 11 1 13 13 13 1 11 11 1 1 1 1 1 1 1 1 11 11 1 1 1 1 1 1 11 11 3 1 13 13 1 1 11 
11 1 1 11 11 1 1 1 1 11 11 11 1 11 11 11 1 1 11 11 11 1 1 11 11 1 1 11 11 11 11 1 1 1 1 13 13 13 1 11 
11 1 1 1 11 1 1 1 1 2 1 1 1 11 11 11 1 1 11 11 11 1 1 1 1 1 11 11 11 11 11 1 1 1 3 13 13 13 13 11 
11 1 1 11 2 1 1 11 11 11 11 11 1 1 1 1 1 1 11 1 2 1 1 1 1 1 1 1 1 1 1 1 11 11 1 13 13 13 13 11 
11 1 1 11 1 1 1 11 11 11 11 11 1 1 11 11 1 1 1 1 11 11 11 1 1 2 1 11 11 11 11 1 11 11 1 1 13 13 13 11 
11 11 1 11 1 1 1 11 11 1 1 1 1 1 11 11 1 1 1 1 1 1 1 13 1 1 1 11 11 1 1 1 11 2 1 1 13 13 1 11 
11 11 1 11 1 11 11 1 1 1 1 1 1 11 11 11 1 11 11 1 1 1 13 13 13 1 1 3 1 1 1 1 1 1 1 11 11 1 1 11 
11 11 1 3 1 11 2 1 1 11 11 11 1 1 11 11 1 11 11 1 13 13 13 13 13 13 13 1 1 3 1 1 1 11 11 11 11 1 1 11 
11 11 1 1 1 11 11 11 1 11 11 11 1 1 1 1 1 11 11 1 13 13 13 13 13 13 13 1 1 11 11 1 1 11 11 11 11 1 11 11 
11 1 1 1 1 11 11 11 1 1 3 1 4 1 11 1 1 11 11 4 1 1 13 13 13 13 13 13 1 11 11 11 1 1 1 1 2 1 11 11 
11 1 3 1 2 11 11 11 1 1 1 1 11 11 11 1 1 11 1 1 1 1 13 13 13 13 13 13 1 11 11 1 1 1 11 1 1 1 11 11 
11 1 1 1 1 11 11 1 1 1 1 11 11 11 11 1 1 1 1 1 1 1 2 13 13 13 13 1 3 1 1 1 11 11 1 3 1 1 11 11 
11 11 1 1 1 1 1 1 1 1 1 11 11 11 1 1 11 11 11 1 11 1 1 13 13 1 1 1 1 1 1 11 11 11 11 1 1 1 11 11 
11 11 11 11 11 11 11 11 1 1 1 1 1 1 1 1 11 11 11 1 11 11 11 1 1 11 11 11 11 1 1 1 1 1 11 1 1 1 1 11 
11 1 1 11 11 11 1 1 3 11 11 11 11 11 1 1 11 11 11 1 1 11 11 1 1 11 11 11 11 1 1 11 11 1 1 1 11 11 1 11 
11 1 1 11 11 11 1 1 1 1 2 11 11 11 1 1 1 1 1 1 1 1 1 1 1 1 1 1 1 1 1 11 11 1 1 11 11 11 1 11 
11 1 3 1 11 11 1 1 11 1 1 1 1 1 1 1 11 11 1 11 11 11 1 1 11 11 1 11 11 11 1 11 11 1 1 11 11 1 1 11 
11 11 1 1 1 11 11 11 11 1 13 1 11 11 11 11 11 11 1 11 11 11 1 11 11 11 1 1 11 11 1 1 1 1 1 1 1 1 1 11 
11 11 1 1 11 11 11 11 1 13 13 13 1 2 11 1 1 1 1 1 1 1 1 11 11 11 1 1 1 2 1 1 1 1 11 11 1 1 11 11 
11 11 1 1 1 1 1 11 13 13 13 13 1 1 11 1 1 1 11 11 11 1 1 11 11 1 1 3 11 11 1 1 11 11 11 11 1 1 11 11 
11 11 1 1 1 1 1 13 13 13 13 13 1 1 11 1 1 1 11 11 11 1 1 1 1 1 1 1 11 11 1 1 1 11 11 11 1 1 11 11 
11 1 1 1 11 11 11 13 13 13 13 1 11 11 1 2 1 1 11 1 1 1 1 1 1 2 1 1 11 1 1 1 1 1 1 1 1 1 11 11 
11 11 1 1 11 11 11 11 13 13 1 1 11 11 1 1 1 1 11 1 1 11 11 11 11 11 1 1 13 13 1 11 11 11 11 11 1 2 11 11 
11 11 11 1 1 1 1 11 11 11 11 11 11 1 1 11 11 11 11 11 2 1 3 1 13 13 13 13 13 13 13 12 11 11 11 1 1 1 11 11 
11 1 1 1 1 2 1 1 1 1 11 11 11 1 1 1 1 1 1 11 1 1 1 13 13 13 13 13 13 13 13 1 1 1 1 2 1 1 11 11 
11 1 1 1 1 11 1 11 11 1 1 1 11 11 11 1 1 2 1 11 1 1 13 13 13 13 13 13 13 13 13 13 2 11 11 11 11 1 11 11 
11 1 1 2 1 11 1 1 1 1 1 1 11 1 11 1 1 1 11 11 3 1 13 13 13 13 13 13 13 13 13 1 1 11 2 1 1 1 11 11 
11 1 1 1 1 11 11 11 11 11 11 11 11 1 1 1 1 3 11 11 1 1 1 1 1 11 11 11 11 11 11 1 1 1 1 1 1 11 11 11 
11 11 11 11 11 11 11 11 11 11 11 11 11 11 11 11 11 11 11 11 11 11 11 11 11 11 11 11 11 11 11 11 11 11 11 11 11 11 11 11